а	a
б	b
в	v
г	g
д	d
е	e
ж	zh
з	z
и	i
й	y
к	k
л	l
м	m
н	n
о	o
п	p
р	r
с	s
т	t
у	u
ф	f
х	kh
ц	ts
ч	ch
ш	sh
щ	shch
ъ	"
ы	y
ь	'
э	*e
ю	yu
я	ya
A	A
Б	B
В	V
Г	G
Д	D
Е	Е
Ё	YO
Ж	ZH
З	Z
И	I
Й	Y
К	K
Л	L
М	M
Н	N
О	O
П	P
Р	R
C	S
T	T
У	U
Ф	F
X	KH
Ц	TS
Ч	CH
Ш	SH
Щ	SCH
Ъ	"
Ы	y
Ь	'
Э	*E
Ю	YU
Я	YA
