а	a
б	b
в	v
г	g
д	d
е	e
ё	oh
ж	zh
з	z
и	i
й	j
к	k
л	l
м	m
н	n
о	o
п	p
р	r
с	s
т	t
у	u
ф	f
х	x
ц	c
ч	ch
ш	sh
щ	w
ъ	qh
ы	y
ь	q
э	eh
ю	ju
я	ja