 я	ya
 ю	yu
 е	ye
а	a
б	b
в	v
г	g
д	d
е	e
ё	yo
ж	zsh
з	z
и	i
й	y
к	k
л	l
м	m
н	n
о	o
п	p
р	r
с	s
т	t
у	u
ф	f
х	h
ц	ts
ч	tch
ш	ch
щ	scsh
ъ	'
ы	uy
ь	'
э	a
ю	u
я	a
