а	a
б	b
в	v
г	g
д	d
дж	dž
дз	dž'
е	e
ё	ë
ж	ž
з	z
и	i
і	ï
й	j
к	k
л	l
м	m
н	n
о	o
ӧ	ö
п	p
р	r
с	s
т	t
тш	č
у	u
ф	f
х	x
ц	c
ч	ć
ш	š
щ	šč
ъ	
ы	y
ь	'
э	è
ю	ju
я	ja
