А	A
Б	B
В	V
Г	G
Д	D
Е	E
Ё	Yo
Ж	Zh
З	Z
И	I
Й	Y
К	K
Л	L
М	M
Н	N
О	O
П	P
Р	R
С	S
Т	T
У	U
Ф	F
Х	H
Ц	TS
Ч	Ch
Ш	Sh
Щ	Sch
Ъ	-
Ы	Y
Ь	-
Э	E
Ю	Yu
Я	Ya